league,season,team,player,nation,pos,age,born,90s,Tkl,TklW,Def 3rd,Mid 3rd,Att 3rd,Tkl,Att,Tkl%,Lost,Blocks,Sh,Pass,Int,Tkl+Int,Clr,Err
ENG-Premier League,1920,Arsenal,Ainsley Maitland-Niles,ENG,DF,21,1997,15.4,41,23,34,5,2,22,43,51.2,21,12,3,9,28,69,38,0
ENG-Premier League,1920,Arsenal,Alexandre Lacazette,FRA,FW,28,1991,20.8,31,16,8,21,2,9,24,37.5,15,14,0,14,7,38,15,0
ENG-Premier League,1920,Arsenal,Bernd Leno,GER,GK,27,1992,29.4,0,0,0,0,0,0,2,0.0,2,0,0,0,0,0,9,2
ENG-Premier League,1920,Arsenal,Bukayo Saka,ENG,"DF,FW",17,2001,19.5,36,21,21,8,7,19,37,51.4,18,12,3,9,12,48,19,0
ENG-Premier League,1920,Arsenal,Calum Chambers,ENG,DF,24,1995,12.2,26,10,12,8,6,11,16,68.8,5,13,7,6,16,42,43,1
ENG-Premier League,1920,Arsenal,Cédric Soares,POR,"MF,DF",27,1991,2.8,8,6,2,6,0,1,3,33.3,2,3,0,3,3,11,4,0
ENG-Premier League,1920,Arsenal,Dani Ceballos,ESP,MF,22,1996,18.8,45,23,26,14,5,18,61,29.5,43,14,3,11,32,77,16,1
ENG-Premier League,1920,Arsenal,David Luiz,BRA,DF,32,1987,31.2,28,16,14,14,0,13,24,54.2,11,42,37,5,32,60,133,2
ENG-Premier League,1920,Arsenal,Eddie Nketiah,ENG,FW,20,1999,7.0,7,5,3,4,0,2,6,33.3,4,9,0,9,2,9,5,0
ENG-Premier League,1920,Arsenal,Emile Smith Rowe,ENG,MF,19,2000,1.1,1,1,1,0,0,1,3,33.3,2,0,0,0,1,2,2,0
ENG-Premier League,1920,Arsenal,Emiliano Martínez,ARG,GK,26,1992,8.6,0,0,0,0,0,0,0,,0,0,0,0,0,0,1,0
ENG-Premier League,1920,Arsenal,Gabriel Martinelli,BRA,FW,18,2001,7.4,20,15,10,6,4,7,20,35.0,13,15,1,14,3,23,8,0
ENG-Premier League,1920,Arsenal,Granit Xhaka,SUI,MF,26,1992,28.7,45,25,20,19,6,25,55,45.5,30,32,16,16,21,66,59,3
ENG-Premier League,1920,Arsenal,Henrikh Mkhitaryan,ARM,FW,30,1989,1.2,0,0,0,0,0,0,2,0.0,2,3,0,3,0,0,1,0
ENG-Premier League,1920,Arsenal,Héctor Bellerín,ESP,"DF,MF",24,1995,12.9,20,13,7,11,2,11,29,37.9,18,20,4,16,19,39,27,1
ENG-Premier League,1920,Arsenal,Joe Willock,ENG,"MF,FW",19,1999,9.5,25,16,9,12,4,8,21,38.1,13,16,2,14,4,29,11,2
ENG-Premier League,1920,Arsenal,Kieran Tierney,SCO,"DF,MF",22,1997,11.0,20,16,13,6,1,11,15,73.3,4,10,4,6,9,29,37,1
ENG-Premier League,1920,Arsenal,Lucas Torreira,URU,MF,23,1996,16.8,31,16,11,15,5,16,39,41.0,23,24,8,16,34,65,24,0
ENG-Premier League,1920,Arsenal,Mattéo Guendouzi,FRA,MF,20,1999,19.4,31,16,14,13,4,14,43,32.6,29,21,7,14,29,60,38,2
ENG-Premier League,1920,Arsenal,Mesut Özil,GER,MF,30,1988,16.0,17,8,9,7,1,4,23,17.4,19,4,0,4,5,22,1,0
ENG-Premier League,1920,Arsenal,Nacho Monreal,ESP,DF,33,1986,3.0,1,1,1,0,0,1,3,33.3,2,3,1,2,3,4,10,0
ENG-Premier League,1920,Arsenal,Nicolas Pépé,CIV,FW,24,1995,22.3,32,17,15,13,4,8,16,50.0,8,15,2,13,8,40,5,0
ENG-Premier League,1920,Arsenal,Pablo Marí,ESP,DF,25,1993,1.3,2,1,2,0,0,0,0,,0,0,0,0,1,3,10,0
ENG-Premier League,1920,Arsenal,Pierre-Emerick Aubameyang,GAB,FW,30,1989,34.8,31,19,10,12,9,12,51,23.5,39,39,1,38,14,45,16,0
ENG-Premier League,1920,Arsenal,Reiss Nelson,ENG,FW,19,1999,7.0,11,8,5,4,2,7,17,41.2,10,13,2,11,3,14,3,0
ENG-Premier League,1920,Arsenal,Rob Holding,ENG,DF,23,1995,6.5,4,2,3,1,0,1,3,33.3,2,10,6,4,5,9,45,1
ENG-Premier League,1920,Arsenal,Sead Kolašinac,BIH,DF,26,1993,18.9,29,16,18,6,5,12,23,52.2,11,14,4,10,25,54,34,1
ENG-Premier League,1920,Arsenal,Shkodran Mustafi,GER,DF,27,1992,13.4,17,10,11,5,1,6,12,50.0,6,10,6,4,18,35,72,0
ENG-Premier League,1920,Arsenal,Sokratis Papastathopoulos,GRE,DF,31,1988,18.8,25,16,17,7,1,10,21,47.6,11,30,24,6,17,42,68,1
ENG-Premier League,1920,Aston Villa,Ahmed Elmohamady,EGY,DF,31,1987,11.5,19,9,10,7,2,10,21,47.6,11,11,5,6,13,32,25,1
ENG-Premier League,1920,Aston Villa,Anwar El Ghazi,NED,"FW,MF",24,1995,22.8,20,11,12,5,3,8,26,30.8,18,10,1,9,13,33,16,1
ENG-Premier League,1920,Aston Villa,Björn Engels,BEL,DF,24,1994,16.1,11,6,8,2,1,8,13,61.5,5,18,17,1,28,39,86,3
ENG-Premier League,1920,Aston Villa,Borja Bastón,ESP,"MF,FW",26,1992,0.2,1,0,0,1,0,0,2,0.0,2,1,0,1,0,1,0,1
ENG-Premier League,1920,Aston Villa,Conor Hourihane,IRL,MF,28,1991,17.0,16,10,4,8,4,10,25,40.0,15,19,4,15,9,25,31,0
ENG-Premier League,1920,Aston Villa,Danny Drinkwater,ENG,MF,29,1990,2.9,5,3,3,2,0,2,18,11.1,16,5,0,5,5,10,5,1
ENG-Premier League,1920,Aston Villa,Douglas Luiz,BRA,MF,21,1998,29.0,46,24,25,17,4,19,65,29.2,46,42,15,27,36,82,54,1
ENG-Premier League,1920,Aston Villa,Ezri Konsa,ENG,DF,21,1997,22.7,18,9,12,6,0,7,16,43.8,9,34,24,10,25,43,70,2
ENG-Premier League,1920,Aston Villa,Frederic Guilbert,FRA,"DF,MF",24,1994,22.7,74,43,48,20,6,36,67,53.7,31,33,10,23,49,123,74,2
ENG-Premier League,1920,Aston Villa,Henri Lansbury,ENG,MF,28,1990,2.2,6,2,3,1,2,2,8,25.0,6,4,0,4,0,6,3,0
ENG-Premier League,1920,Aston Villa,Indiana Vassilev,USA,"FW,MF",18,2001,0.6,0,0,0,0,0,0,0,,0,0,0,0,0,0,0,0
ENG-Premier League,1920,Aston Villa,Jack Grealish,ENG,"FW,MF",23,1995,35.9,29,19,12,12,5,13,34,38.2,21,33,12,21,22,51,22,1
ENG-Premier League,1920,Aston Villa,Jed Steer,ENG,GK,26,1992,0.1,0,0,0,0,0,0,0,,0,0,0,0,0,0,0,0
ENG-Premier League,1920,Aston Villa,John McGinn,SCO,MF,24,1994,25.7,53,35,19,23,11,18,62,29.0,44,25,1,24,25,78,18,0
ENG-Premier League,1920,Aston Villa,Jonathan Kodjia,CIV,FW,29,1989,1.3,0,0,0,0,0,0,1,0.0,1,0,0,0,0,0,1,0
ENG-Premier League,1920,Aston Villa,Jota,ESP,"FW,MF",28,1991,3.7,3,1,2,0,1,2,5,40.0,3,1,0,1,3,6,6,0
ENG-Premier League,1920,Aston Villa,Keinan Davis,ENG,FW,21,1998,6.1,1,1,0,1,0,0,3,0.0,3,4,0,4,0,1,3,0
ENG-Premier League,1920,Aston Villa,Kortney Hause,ENG,DF,24,1995,17.2,21,9,15,5,1,8,15,53.3,7,27,19,8,20,41,98,4
ENG-Premier League,1920,Aston Villa,Marvelous Nakamba,ZIM,MF,25,1994,20.4,55,28,28,20,7,24,67,35.8,43,50,11,39,39,94,38,3
ENG-Premier League,1920,Aston Villa,Matt Targett,ENG,"DF,MF",23,1995,25.5,52,29,37,11,4,22,53,41.5,31,28,8,20,56,108,82,0
ENG-Premier League,1920,Aston Villa,Mbwana Samatta,TAN,FW,26,1992,10.5,6,4,0,3,3,1,8,12.5,7,7,0,7,1,7,6,0
ENG-Premier League,1920,Aston Villa,Neil Taylor,WAL,DF,30,1989,12.1,16,11,12,4,0,11,20,55.0,9,15,5,10,20,36,43,0
ENG-Premier League,1920,Aston Villa,Pepe Reina,ESP,GK,36,1982,12.0,0,0,0,0,0,0,2,0.0,2,0,0,0,0,0,9,1
ENG-Premier League,1920,Aston Villa,Tom Heaton,ENG,GK,33,1986,19.9,3,2,3,0,0,3,4,75.0,1,0,0,0,0,3,6,0
ENG-Premier League,1920,Aston Villa,Trézéguet,EGY,"FW,MF",24,1994,21.7,38,16,18,15,5,9,44,20.5,35,23,2,21,25,63,18,0
ENG-Premier League,1920,Aston Villa,Tyrone Mings,ENG,DF,26,1993,32.2,15,11,11,3,1,10,13,76.9,3,56,48,8,30,45,190,4
ENG-Premier League,1920,Aston Villa,Wesley Moraes,BRA,FW,22,1996,19.8,15,8,3,8,4,0,5,0.0,5,10,2,8,4,19,23,0
ENG-Premier League,1920,Aston Villa,Ørjan Nyland,NOR,GK,28,1990,6.0,0,0,0,0,0,0,0,,0,0,0,0,0,0,1,1
ENG-Premier League,1920,Bournemouth,Aaron Ramsdale,ENG,GK,21,1998,37.0,4,3,4,0,0,3,3,100.0,0,0,0,0,0,4,25,1
ENG-Premier League,1920,Bournemouth,Adam Smith,ENG,DF,28,1991,22.8,47,32,29,16,2,23,50,46.0,27,27,6,21,25,72,64,1
ENG-Premier League,1920,Bournemouth,Andrew Surman,ENG,MF,32,1986,2.6,4,2,2,2,0,1,3,33.3,2,1,0,1,1,5,5,1
ENG-Premier League,1920,Bournemouth,Arnaut Danjuma,NED,MF,22,1997,7.0,4,2,3,1,0,1,4,25.0,3,2,0,2,8,12,4,1
ENG-Premier League,1920,Bournemouth,Callum Wilson,ENG,FW,27,1992,32.3,12,9,3,6,3,2,17,11.8,15,16,2,14,4,16,16,0
ENG-Premier League,1920,Bournemouth,Charlie Daniels,ENG,DF,32,1986,1.4,1,1,0,1,0,0,1,0.0,1,2,0,2,1,2,5,1
ENG-Premier League,1920,Bournemouth,Chris Mepham,WAL,DF,21,1997,10.1,20,9,13,7,0,11,14,78.6,3,17,11,6,17,37,62,1
ENG-Premier League,1920,Bournemouth,Dan Gosling,ENG,MF,29,1990,14.0,26,10,14,9,3,6,27,22.2,21,31,11,20,20,46,26,0
ENG-Premier League,1920,Bournemouth,David Brooks,WAL,"MF,FW",22,1997,5.6,5,5,1,2,2,2,14,14.3,12,5,1,4,2,7,1,0
ENG-Premier League,1920,Bournemouth,Diego Rico,ESP,DF,26,1993,25.9,61,39,32,24,5,29,59,49.2,30,31,7,24,84,145,91,0
ENG-Premier League,1920,Bournemouth,Dominic Solanke,ENG,FW,21,1997,18.3,8,4,2,5,1,5,33,15.2,28,9,1,8,8,16,18,1
ENG-Premier League,1920,Bournemouth,Harry Wilson,WAL,"MF,FW",22,1997,18.3,23,13,8,10,5,11,34,32.4,23,26,2,24,11,34,15,1
ENG-Premier League,1920,Bournemouth,Jack Simpson,ENG,DF,22,1996,2.7,5,2,4,1,0,2,8,25.0,6,1,0,1,2,7,12,1
ENG-Premier League,1920,Bournemouth,Jack Stacey,ENG,DF,23,1996,17.2,21,11,9,11,1,8,22,36.4,14,27,11,16,18,39,64,1
ENG-Premier League,1920,Bournemouth,Jefferson Lerma,COL,MF,24,1994,30.0,54,32,17,31,6,22,48,45.8,26,28,12,16,57,111,54,1
ENG-Premier League,1920,Bournemouth,Jordon Ibe,ENG,DF,23,1995,0.6,2,2,2,0,0,1,1,100.0,0,0,0,0,0,2,1,0
ENG-Premier League,1920,Bournemouth,Joshua King,NOR,"FW,MF",27,1992,22.3,16,6,4,8,4,4,16,25.0,12,20,3,17,8,24,9,0
ENG-Premier League,1920,Bournemouth,Junior Stanislas,ENG,"MF,FW",29,1989,7.9,10,7,2,3,5,3,8,37.5,5,6,0,6,4,14,6,0
ENG-Premier League,1920,Bournemouth,Lewis Cook,ENG,"MF,FW",22,1997,15.0,27,14,15,9,3,10,47,21.3,37,17,5,12,17,44,17,1
ENG-Premier League,1920,Bournemouth,Lloyd Kelly,ENG,DF,20,1998,7.1,7,3,3,4,0,6,7,85.7,1,9,5,4,6,13,15,1
ENG-Premier League,1920,Bournemouth,Mark Travers,IRL,GK,20,1999,1.0,0,0,0,0,0,0,0,,0,0,0,0,0,0,1,1
ENG-Premier League,1920,Bournemouth,Nathan Aké,NED,DF,24,1995,27.8,31,21,23,8,0,14,23,60.9,9,40,29,11,36,67,152,0
ENG-Premier League,1920,Bournemouth,Philip Billing,DEN,MF,23,1996,28.1,72,46,30,37,5,17,65,26.2,48,59,16,43,66,138,97,1
ENG-Premier League,1920,Bournemouth,Ryan Fraser,SCO,"MF,FW",25,1994,23.0,12,6,5,5,2,7,22,31.8,15,15,3,12,15,27,24,0
ENG-Premier League,1920,Bournemouth,Sam Surridge,ENG,"FW,MF",21,1998,0.3,0,0,0,0,0,0,0,,0,1,0,1,1,1,0,0
ENG-Premier League,1920,Bournemouth,Simon Francis,ENG,DF,34,1985,10.8,13,9,11,2,0,11,21,52.4,10,17,12,5,20,33,71,0
ENG-Premier League,1920,Bournemouth,Steve Cook,ENG,DF,28,1991,27.0,22,11,18,4,0,8,20,40.0,12,32,23,9,44,66,153,1
ENG-Premier League,1920,Brighton,Aaron Connolly,IRL,FW,19,2000,14.0,7,6,1,4,2,3,10,30.0,7,11,0,11,0,7,3,0
ENG-Premier League,1920,Brighton,Aaron Mooy,AUS,"MF,FW",28,1990,23.2,37,24,9,18,10,6,40,15.0,34,36,7,29,23,60,32,1
ENG-Premier League,1920,Brighton,Adam Webster,ENG,DF,24,1995,29.6,30,17,21,8,1,14,32,43.8,18,43,26,17,45,75,110,2
ENG-Premier League,1920,Brighton,Alexis Mac Allister,ARG,"MF,FW",20,1998,3.9,9,5,4,3,2,5,9,55.6,4,12,0,12,1,10,2,0
ENG-Premier League,1920,Brighton,Alireza Jahanbakhsh,IRN,"FW,MF",25,1993,3.5,8,4,3,2,3,0,2,0.0,2,5,0,5,3,11,2,0
ENG-Premier League,1920,Brighton,Bernardo,BRA,"DF,MF",24,1995,7.5,27,16,12,9,6,13,17,76.5,4,7,3,4,6,33,24,0
ENG-Premier League,1920,Brighton,Dale Stephens,ENG,MF,30,1989,28.1,73,44,30,37,6,25,75,33.3,50,31,11,20,58,131,42,2
ENG-Premier League,1920,Brighton,Dan Burn,ENG,DF,27,1992,32.0,67,42,35,27,5,25,53,47.2,28,44,20,24,42,109,130,0
ENG-Premier League,1920,Brighton,Davy Pröpper,NED,MF,27,1991,31.4,64,35,28,28,8,23,74,31.1,51,27,8,19,38,102,36,4
ENG-Premier League,1920,Brighton,Ezequiel Schelotto,ITA,DF,30,1989,4.0,4,3,1,2,1,2,8,25.0,6,3,0,3,7,11,14,0
ENG-Premier League,1920,Brighton,Florin Andone,ROU,FW,26,1993,0.8,1,1,0,1,0,1,1,100.0,0,1,1,0,0,1,1,0
ENG-Premier League,1920,Brighton,Gaëtan Bong,CMR,"DF,MF",31,1988,0.7,1,0,0,0,1,0,0,,0,1,1,0,0,1,0,0
ENG-Premier League,1920,Brighton,Glenn Murray,ENG,FW,35,1983,8.9,5,2,0,3,2,2,9,22.2,7,6,2,4,1,6,12,0
ENG-Premier League,1920,Brighton,Jürgen Locadia,CUW,"FW,MF",25,1993,1.0,0,0,0,0,0,0,0,,0,0,0,0,0,0,0,0
ENG-Premier League,1920,Brighton,Leandro Trossard,BEL,"FW,MF",24,1994,22.3,22,17,7,12,3,6,38,15.8,32,16,1,15,9,31,8,0
ENG-Premier League,1920,Brighton,Lewis Dunk,ENG,DF,27,1991,35.9,40,24,23,17,0,15,34,44.1,19,55,33,22,55,95,125,2
ENG-Premier League,1920,Brighton,Martín Montoya,ESP,"DF,MF",28,1991,21.1,57,29,31,20,6,30,56,53.6,26,19,5,14,24,81,40,0
ENG-Premier League,1920,Brighton,Mathew Ryan,AUS,GK,27,1992,38.0,1,1,1,0,0,1,4,25.0,3,0,0,0,2,3,13,2
ENG-Premier League,1920,Brighton,Neal Maupay,FRA,FW,22,1996,30.7,20,12,1,13,6,9,29,31.0,20,24,0,24,4,24,10,0
ENG-Premier League,1920,Brighton,Pascal Groß,GER,"MF,FW",28,1991,20.0,36,13,8,21,7,14,39,35.9,25,25,3,22,9,45,7,0
ENG-Premier League,1920,Brighton,Shane Duffy,IRL,DF,27,1992,13.8,18,9,14,4,0,6,17,35.3,11,13,7,6,21,39,72,0
ENG-Premier League,1920,Brighton,Solly March,ENG,"FW,MF",25,1994,12.7,25,12,16,6,3,9,19,47.4,10,16,4,12,20,45,14,2
ENG-Premier League,1920,Brighton,Steven Alzate,COL,"MF,DF",20,1998,13.2,33,19,20,11,2,17,27,63.0,10,18,3,15,14,47,13,0
ENG-Premier League,1920,Brighton,Tariq Lamptey,GHA,DF,18,2000,6.5,7,6,6,1,0,2,9,22.2,7,6,0,6,16,23,17,0
ENG-Premier League,1920,Brighton,Yves Bissouma,MLI,MF,22,1996,14.0,49,38,24,22,3,17,40,42.5,23,18,2,16,21,70,23,0
ENG-Premier League,1920,Burnley,Aaron Lennon,ENG,MF,32,1987,5.5,14,8,7,4,3,7,10,70.0,3,6,1,5,8,22,3,0
ENG-Premier League,1920,Burnley,Ashley Barnes,ENG,FW,29,1989,15.0,10,5,3,5,2,3,9,33.3,6,7,2,5,6,16,9,0
ENG-Premier League,1920,Burnley,Ashley Westwood,ENG,MF,29,1990,35.0,54,33,15,32,7,17,48,35.4,31,23,11,12,32,86,32,3
ENG-Premier League,1920,Burnley,Ben Mee,ENG,DF,29,1989,32.0,41,22,25,16,0,17,29,58.6,12,42,31,11,42,83,165,2
ENG-Premier League,1920,Burnley,Charlie Taylor,ENG,DF,25,1993,21.6,39,24,26,9,4,19,39,48.7,20,29,9,20,29,68,78,1
ENG-Premier League,1920,Burnley,Chris Wood,NZL,FW,27,1991,27.1,7,4,2,4,1,5,15,33.3,10,15,2,13,4,11,18,0
ENG-Premier League,1920,Burnley,Danny Drinkwater,ENG,MF,29,1990,0.6,2,1,1,1,0,0,1,0.0,1,0,0,0,1,3,0,0
ENG-Premier League,1920,Burnley,Dwight McNeil,ENG,MF,19,1999,37.1,47,33,18,22,7,23,71,32.4,48,60,8,52,30,77,34,0
ENG-Premier League,1920,Burnley,Erik Pieters,NED,"DF,MF",30,1988,20.9,54,32,18,29,7,28,69,40.6,41,30,4,26,28,82,60,1
ENG-Premier League,1920,Burnley,Jack Cork,ENG,MF,30,1989,29.0,35,24,10,20,5,12,62,19.4,50,34,12,22,28,63,49,0
ENG-Premier League,1920,Burnley,James Tarkowski,ENG,DF,26,1992,38.0,66,43,47,19,0,31,54,57.4,23,63,47,16,63,129,204,4
ENG-Premier League,1920,Burnley,Jay Rodriguez,ENG,FW,30,1989,22.4,29,19,4,13,12,8,33,24.2,25,33,6,27,5,34,12,0
ENG-Premier League,1920,Burnley,Jeff Hendrick,IRL,MF,27,1992,21.5,18,10,7,8,3,7,27,25.9,20,21,8,13,20,38,20,0
ENG-Premier League,1920,Burnley,Josh Brownhill,ENG,MF,23,1995,8.9,14,8,5,7,2,5,13,38.5,8,9,4,5,14,28,18,0
ENG-Premier League,1920,Burnley,Jóhann Berg Guðmundsson,ISL,MF,28,1990,6.9,4,2,2,2,0,1,8,12.5,7,8,1,7,7,11,9,0
ENG-Premier League,1920,Burnley,Kevin Long,IRL,DF,28,1990,6.3,7,5,6,1,0,4,9,44.4,5,9,7,2,4,11,31,0
ENG-Premier League,1920,Burnley,Matthew Lowton,ENG,DF,30,1989,17.0,41,22,20,18,3,22,33,66.7,11,20,6,14,27,68,57,1
ENG-Premier League,1920,Burnley,Matěj Vydra,CZE,FW,27,1992,9.1,4,3,0,3,1,3,6,50.0,3,7,3,4,1,5,6,0
ENG-Premier League,1920,Burnley,Max Thompson,ENG,FW,17,2002,0.0,0,0,0,0,0,0,0,,0,0,0,0,0,0,0,0
ENG-Premier League,1920,Burnley,Nick Pope,ENG,GK,27,1992,38.0,1,1,1,0,0,1,2,50.0,1,0,0,0,3,4,15,3
ENG-Premier League,1920,Burnley,Phil Bardsley,SCO,DF,34,1985,21.0,49,36,16,24,9,24,37,64.9,13,24,11,13,30,79,73,0
ENG-Premier League,1920,Burnley,Robbie Brady,IRL,MF,27,1992,5.0,11,9,5,4,2,3,10,30.0,7,10,2,8,5,16,8,0
ENG-Premier League,1920,Chelsea,Andreas Christensen,DEN,DF,23,1996,19.5,38,21,25,12,1,15,21,71.4,6,12,8,4,29,67,56,0
ENG-Premier League,1920,Chelsea,Antonio Rüdiger,GER,DF,26,1993,19.0,28,18,19,7,2,16,25,64.0,9,15,9,6,16,44,59,1
ENG-Premier League,1920,Chelsea,Armando Broja,ALB,FW,17,2001,0.1,0,0,0,0,0,0,0,,0,0,0,0,0,0,0,0
ENG-Premier League,1920,Chelsea,Billy Gilmour,SCO,MF,18,2001,2.2,5,2,3,2,0,2,4,50.0,2,2,0,2,3,8,3,1
ENG-Premier League,1920,Chelsea,Callum Hudson-Odoi,ENG,"FW,MF",18,2000,9.6,10,4,4,5,1,1,7,14.3,6,9,0,9,5,15,4,1
ENG-Premier League,1920,Chelsea,Christian Pulisic,USA,FW,20,1998,19.1,23,11,13,4,6,7,24,29.2,17,15,0,15,6,29,11,0
ENG-Premier League,1920,Chelsea,César Azpilicueta,ESP,DF,29,1989,35.9,86,56,40,32,14,35,69,50.7,34,56,21,35,67,153,94,0
ENG-Premier League,1920,Chelsea,Emerson Palmieri,ITA,DF,24,1994,11.4,23,12,8,11,4,10,15,66.7,5,13,1,12,18,41,19,0
ENG-Premier League,1920,Chelsea,Faustino Anjorin,ENG,FW,17,2001,0.2,0,0,0,0,0,0,0,,0,1,0,1,0,0,0,0
ENG-Premier League,1920,Chelsea,Fikayo Tomori,ENG,DF,21,1997,14.3,29,16,21,8,0,10,15,66.7,5,13,7,6,22,51,48,2
ENG-Premier League,1920,Chelsea,Jorginho,ITA,MF,27,1991,26.4,66,40,24,34,8,35,91,38.5,56,30,5,25,64,130,27,2
ENG-Premier League,1920,Chelsea,Kepa Arrizabalaga,ESP,GK,24,1994,33.0,1,1,1,0,0,1,2,50.0,1,0,0,0,1,2,7,2
ENG-Premier League,1920,Chelsea,Kurt Zouma,FRA,DF,24,1994,26.0,23,14,17,6,0,9,16,56.3,7,22,14,8,58,81,116,2
ENG-Premier League,1920,Chelsea,Marcos Alonso,ESP,DF,28,1990,15.9,28,16,20,6,2,14,33,42.4,19,18,2,16,20,48,32,0
ENG-Premier League,1920,Chelsea,Mason Mount,ENG,"MF,FW",20,1999,31.9,37,17,8,19,10,9,42,21.4,33,25,3,22,16,53,18,0
ENG-Premier League,1920,Chelsea,Mateo Kovačić,CRO,MF,25,1994,23.0,63,38,29,32,2,26,65,40.0,39,15,1,14,22,85,16,1
ENG-Premier League,1920,Chelsea,Michy Batshuayi,BEL,FW,25,1993,2.7,4,1,2,2,0,0,5,0.0,5,1,1,0,0,4,1,0
ENG-Premier League,1920,Chelsea,N'Golo Kanté,FRA,MF,28,1991,19.2,44,20,22,14,8,17,36,47.2,19,29,5,24,44,88,32,2
ENG-Premier League,1920,Chelsea,Olivier Giroud,FRA,FW,32,1986,11.0,8,3,2,5,1,1,11,9.1,10,14,1,13,2,10,13,0
ENG-Premier League,1920,Chelsea,Pedro,ESP,"FW,MF",32,1987,7.3,15,7,5,9,1,3,15,20.0,12,9,0,9,9,24,1,0
ENG-Premier League,1920,Chelsea,Reece James,ENG,DF,19,1999,16.8,36,23,18,14,4,11,29,37.9,18,19,8,11,22,58,28,0
ENG-Premier League,1920,Chelsea,Ross Barkley,ENG,MF,25,1993,12.3,16,9,6,6,4,5,18,27.8,13,7,2,5,7,23,7,0
ENG-Premier League,1920,Chelsea,Ruben Loftus-Cheek,ENG,"MF,FW",23,1996,2.3,0,0,0,0,0,0,2,0.0,2,1,1,0,2,2,2,0
ENG-Premier League,1920,Chelsea,Tammy Abraham,ENG,FW,21,1997,24.6,8,4,2,5,1,3,14,21.4,11,20,2,18,6,14,27,0
ENG-Premier League,1920,Chelsea,Tariq Lamptey,GHA,DF,18,2000,0.4,2,2,1,1,0,2,2,100.0,0,0,0,0,0,2,0,0
ENG-Premier League,1920,Chelsea,Willian,BRA,"FW,MF",30,1988,28.9,45,27,14,24,7,14,43,32.6,29,15,0,15,20,65,7,0
ENG-Premier League,1920,Chelsea,Willy Caballero,ARG,GK,37,1981,5.0,0,0,0,0,0,0,0,,0,0,0,0,0,0,3,0
ENG-Premier League,1920,Crystal Palace,Andros Townsend,ENG,"FW,MF",28,1991,14.4,34,21,12,17,5,15,37,40.5,22,18,0,18,15,49,10,1
ENG-Premier League,1920,Crystal Palace,Brandon Pierrick,ENG,"MF,FW",17,2001,0.2,0,0,0,0,0,0,0,,0,0,0,0,0,0,1,0
ENG-Premier League,1920,Crystal Palace,Cenk Tosun,TUR,FW,28,1991,2.0,2,2,2,0,0,0,2,0.0,2,0,0,0,0,2,1,0
ENG-Premier League,1920,Crystal Palace,Cheikhou Kouyaté,SEN,"MF,DF",29,1989,28.1,67,32,43,20,4,26,48,54.2,22,35,11,24,43,110,58,1
ENG-Premier League,1920,Crystal Palace,Christian Benteke,BEL,FW,28,1990,14.0,9,5,1,6,2,0,10,0.0,10,11,4,7,4,13,28,1
ENG-Premier League,1920,Crystal Palace,Connor Wickham,ENG,"FW,MF",26,1993,1.1,1,1,1,0,0,0,0,,0,1,0,1,1,2,0,0
ENG-Premier League,1920,Crystal Palace,Gary Cahill,ENG,DF,33,1985,24.1,15,8,11,4,0,7,15,46.7,8,34,25,9,18,33,114,1
ENG-Premier League,1920,Crystal Palace,James McArthur,SCO,MF,31,1987,34.3,88,51,43,34,11,37,106,34.9,69,69,19,50,60,148,56,0
ENG-Premier League,1920,Crystal Palace,James McCarthy,IRL,MF,28,1990,18.7,82,47,36,36,10,40,76,52.6,36,24,5,19,24,106,11,0
ENG-Premier League,1920,Crystal Palace,James Tomkins,ENG,DF,30,1989,17.6,29,17,21,8,0,18,25,72.0,7,17,15,2,21,50,103,0
ENG-Premier League,1920,Crystal Palace,Jaïro Riedewald,NED,"DF,MF",22,1996,8.5,14,10,4,10,0,7,11,63.6,4,7,2,5,17,31,23,1
ENG-Premier League,1920,Crystal Palace,Jeffrey Schlupp,GHA,"FW,MF",26,1992,11.5,18,9,10,7,1,6,16,37.5,10,11,3,8,13,31,15,0
ENG-Premier League,1920,Crystal Palace,Joel Ward,ENG,DF,29,1989,26.5,69,42,48,16,5,39,56,69.6,17,13,6,7,48,117,93,1
ENG-Premier League,1920,Crystal Palace,Jordan Ayew,GHA,FW,27,1991,35.0,48,30,10,22,16,17,49,34.7,32,29,4,25,15,63,21,0
ENG-Premier League,1920,Crystal Palace,Luka Milivojević,SRB,MF,28,1991,27.9,61,32,32,25,4,35,84,41.7,49,30,7,23,42,103,39,4
ENG-Premier League,1920,Crystal Palace,Mamadou Sakho,FRA,DF,29,1990,10.3,7,5,5,1,1,2,5,40.0,3,12,5,7,20,27,46,2
ENG-Premier League,1920,Crystal Palace,Martin Kelly,ENG,DF,29,1990,17.2,23,18,19,4,0,14,31,45.2,17,18,10,8,16,39,86,1
ENG-Premier League,1920,Crystal Palace,Max Meyer,GER,"MF,FW",23,1995,7.3,19,11,10,9,0,8,18,44.4,10,6,1,5,7,26,4,0
ENG-Premier League,1920,Crystal Palace,Patrick van Aanholt,NED,DF,28,1990,27.9,43,23,31,10,2,23,50,46.0,27,31,9,22,45,88,52,1
ENG-Premier League,1920,Crystal Palace,Scott Dann,ENG,DF,32,1987,14.1,8,4,7,1,0,8,14,57.1,6,9,7,2,14,22,67,0
ENG-Premier League,1920,Crystal Palace,Tyrick Mitchell,ENG,DF,19,1999,2.2,5,2,2,2,1,1,7,14.3,6,2,0,2,2,7,3,0
ENG-Premier League,1920,Crystal Palace,Vicente Guaita,ESP,GK,32,1987,35.0,1,1,1,0,0,1,2,50.0,1,0,0,0,0,1,18,3
ENG-Premier League,1920,Crystal Palace,Víctor Camarasa,ESP,FW,25,1994,0.1,0,0,0,0,0,0,0,,0,0,0,0,0,0,0,0
ENG-Premier League,1920,Crystal Palace,Wayne Hennessey,WAL,GK,32,1987,3.0,0,0,0,0,0,0,0,,0,0,0,0,1,1,3,1
ENG-Premier League,1920,Crystal Palace,Wilfried Zaha,CIV,"FW,MF",26,1992,36.4,43,19,18,12,13,12,49,24.5,37,22,2,20,18,61,4,0
ENG-Premier League,1920,Everton,Alex Iwobi,NGA,"MF,FW",23,1996,17.7,25,17,8,15,2,12,33,36.4,21,18,2,16,14,39,10,1
ENG-Premier League,1920,Everton,André Gomes,POR,MF,26,1993,16.2,22,15,7,11,4,8,62,12.9,54,20,3,17,7,29,7,0
ENG-Premier League,1920,Everton,Anthony Gordon,ENG,"MF,FW",18,2001,4.9,11,7,5,6,0,5,15,33.3,10,6,2,4,8,19,4,0
ENG-Premier League,1920,Everton,Bernard,BRA,"MF,FW",26,1992,14.2,32,22,12,14,6,13,44,29.5,31,22,2,20,16,48,7,0
ENG-Premier League,1920,Everton,Cenk Tosun,TUR,FW,28,1991,3.2,2,0,0,0,2,0,1,0.0,1,1,0,1,0,2,1,0
ENG-Premier League,1920,Everton,Djibril Sidibé,FRA,"DF,MF",27,1992,20.3,83,44,48,25,10,43,72,59.7,29,19,3,16,40,123,41,0
ENG-Premier League,1920,Everton,Dominic Calvert-Lewin,ENG,FW,22,1997,29.2,7,5,1,4,2,1,10,10.0,9,15,2,13,6,13,36,0
ENG-Premier League,1920,Everton,Fabian Delph,ENG,MF,29,1989,13.2,26,12,10,13,3,9,22,40.9,13,12,3,9,15,41,19,1
ENG-Premier League,1920,Everton,Gylfi Sigurðsson,ISL,MF,29,1989,28.4,50,26,15,24,11,19,70,27.1,51,30,4,26,37,87,17,1
ENG-Premier League,1920,Everton,Jarrad Branthwaite,ENG,DF,17,2002,3.3,8,7,5,3,0,3,5,60.0,2,6,3,3,2,10,12,0
ENG-Premier League,1920,Everton,Jean-Philippe Gbamin,CIV,MF,23,1995,1.5,4,3,1,1,2,1,2,50.0,1,1,0,1,1,5,4,0
ENG-Premier League,1920,Everton,Jordan Pickford,ENG,GK,25,1994,38.0,0,0,0,0,0,0,4,0.0,4,0,0,0,3,3,12,6
ENG-Premier League,1920,Everton,Leighton Baines,ENG,DF,34,1984,4.5,10,6,6,2,2,8,10,80.0,2,5,2,3,5,15,14,0
ENG-Premier League,1920,Everton,Lucas Digne,FRA,DF,26,1993,33.7,73,49,49,19,5,33,68,48.5,35,39,10,29,42,115,108,0
ENG-Premier League,1920,Everton,Mason Holgate,ENG,DF,22,1996,22.8,44,26,30,13,1,21,31,67.7,10,26,13,13,34,78,97,0
ENG-Premier League,1920,Everton,Michael Keane,ENG,DF,26,1993,28.4,31,16,18,12,1,14,24,58.3,10,35,28,7,44,75,152,0
ENG-Premier League,1920,Everton,Moise Kean,ITA,FW,19,2000,9.5,6,6,5,1,0,0,0,,0,4,0,4,5,11,1,1
ENG-Premier League,1920,Everton,Morgan Schneiderlin,FRA,MF,29,1989,11.1,31,22,13,16,2,8,24,33.3,16,13,3,10,21,52,20,1
ENG-Premier League,1920,Everton,Oumar Niasse,SEN,FW,29,1990,0.2,4,0,0,2,2,0,0,,0,0,0,0,1,5,0,0
ENG-Premier League,1920,Everton,Richarlison,BRA,"FW,MF",22,1997,34.1,70,47,28,28,14,27,56,48.2,29,34,4,30,12,82,42,0
ENG-Premier League,1920,Everton,Séamus Coleman,IRL,DF,30,1988,20.4,42,31,24,14,4,19,25,76.0,6,21,9,12,24,66,43,1
ENG-Premier League,1920,Everton,Theo Walcott,ENG,"MF,FW",30,1989,14.3,13,8,6,5,2,3,15,20.0,12,13,0,13,8,21,1,0
ENG-Premier League,1920,Everton,Tom Davies,ENG,MF,21,1998,22.5,38,17,12,22,4,17,55,30.9,38,12,4,8,35,73,28,0
ENG-Premier League,1920,Everton,Yerry Mina,COL,DF,24,1994,25.4,39,22,25,12,2,18,24,75.0,6,20,14,6,28,67,102,1
ENG-Premier League,1920,Leicester City,Ayoze Pérez,ESP,"MF,FW",26,1993,22.3,45,28,14,26,5,8,54,14.8,46,33,1,32,14,59,9,1
ENG-Premier League,1920,Leicester City,Ben Chilwell,ENG,DF,22,1996,26.4,43,26,28,13,2,23,52,44.2,29,30,6,24,28,71,68,2
ENG-Premier League,1920,Leicester City,Christian Fuchs,AUT,DF,33,1986,8.6,14,9,8,6,0,8,19,42.1,11,8,3,5,17,31,33,1
ENG-Premier League,1920,Leicester City,Demarai Gray,JAM,"MF,FW",23,1996,6.9,12,6,6,6,0,6,12,50.0,6,7,0,7,5,17,4,0
ENG-Premier League,1920,Leicester City,Dennis Praet,BEL,MF,25,1994,12.6,33,18,8,21,4,9,29,31.0,20,19,1,18,17,50,12,0
ENG-Premier League,1920,Leicester City,George Hirst,ENG,"MF,DF",20,1999,0.1,0,0,0,0,0,0,0,,0,0,0,0,0,0,0,0
ENG-Premier League,1920,Leicester City,Hamza Choudhury,ENG,MF,21,1997,9.9,17,8,7,8,2,3,25,12.0,22,15,6,9,24,41,13,0
ENG-Premier League,1920,Leicester City,Harvey Barnes,ENG,"MF,FW",21,1997,23.1,16,11,7,7,2,5,23,21.7,18,13,3,10,8,24,6,1
ENG-Premier League,1920,Leicester City,James Justin,ENG,"DF,MF",21,1998,11.2,36,17,22,14,0,15,25,60.0,10,15,7,8,11,47,30,0
ENG-Premier League,1920,Leicester City,James Maddison,ENG,MF,22,1996,29.2,59,30,13,31,15,23,68,33.8,45,16,0,16,9,68,7,1
ENG-Premier League,1920,Leicester City,Jamie Vardy,ENG,FW,32,1987,33.7,15,12,0,9,6,2,4,50.0,2,22,4,18,2,17,22,0
ENG-Premier League,1920,Leicester City,Jonny Evans,NIR,DF,31,1988,37.6,48,34,33,14,1,28,39,71.8,11,33,18,15,57,105,174,4
ENG-Premier League,1920,Leicester City,Kasper Schmeichel,DEN,GK,32,1986,38.0,1,1,1,0,0,1,2,50.0,1,0,0,0,1,2,4,2
ENG-Premier League,1920,Leicester City,Kelechi Iheanacho,NGA,FW,22,1996,10.7,3,1,1,2,0,1,9,11.1,8,8,1,7,3,6,8,0
ENG-Premier League,1920,Leicester City,Luke Thomas,ENG,"MF,DF",18,2001,3.0,1,0,0,1,0,0,3,0.0,3,2,0,2,3,4,7,0
ENG-Premier League,1920,Leicester City,Marc Albrighton,ENG,"MF,DF",29,1989,9.6,24,17,10,13,1,9,30,30.0,21,19,2,17,10,34,8,0
ENG-Premier League,1920,Leicester City,Matty James,ENG,MF,28,1991,0.1,0,0,0,0,0,0,0,,0,0,0,0,0,0,0,0
ENG-Premier League,1920,Leicester City,Nampalys Mendy,SEN,MF,27,1992,3.2,7,5,4,1,2,4,5,80.0,1,4,1,3,6,13,6,0
ENG-Premier League,1920,Leicester City,Ricardo Pereira,POR,DF,25,1993,28.0,119,68,65,36,18,53,106,50.0,53,38,6,32,49,168,86,0
ENG-Premier League,1920,Leicester City,Ryan Bennett,ENG,DF,29,1990,3.7,5,4,3,2,0,4,6,66.7,2,3,1,2,7,12,8,0
ENG-Premier League,1920,Leicester City,Wes Morgan,JAM,DF,35,1984,4.8,4,1,3,1,0,0,3,0.0,3,5,3,2,7,11,19,0
ENG-Premier League,1920,Leicester City,Wilfred Ndidi,NGA,MF,22,1996,29.7,128,67,56,61,11,45,91,49.5,46,52,6,46,80,208,69,3
ENG-Premier League,1920,Leicester City,Youri Tielemans,BEL,MF,22,1997,31.4,52,29,17,30,5,24,74,32.4,50,43,4,39,22,74,18,0
ENG-Premier League,1920,Leicester City,Çağlar Söyüncü,TUR,DF,23,1996,33.7,60,40,41,18,1,27,46,58.7,19,35,19,16,43,103,156,1
ENG-Premier League,1920,Liverpool,Adam Lallana,ENG,"MF,FW",31,1988,4.2,19,9,7,9,3,6,21,28.6,15,7,0,7,5,24,3,0
ENG-Premier League,1920,Liverpool,Adrián,ESP,GK,32,1987,9.7,1,1,1,0,0,1,1,100.0,0,0,0,0,0,1,8,3
ENG-Premier League,1920,Liverpool,Alex Oxlade-Chamberlain,ENG,"MF,FW",25,1993,16.5,18,9,4,6,8,5,21,23.8,16,26,1,25,22,40,10,0
ENG-Premier League,1920,Liverpool,Alisson,BRA,GK,26,1992,28.3,0,0,0,0,0,0,2,0.0,2,0,0,0,1,1,13,3
ENG-Premier League,1920,Liverpool,Andrew Robertson,SCO,DF,25,1994,34.6,54,31,17,25,12,27,61,44.3,34,29,7,22,38,92,72,1
ENG-Premier League,1920,Liverpool,Curtis Jones,ENG,MF,18,2001,1.4,4,4,0,1,3,3,4,75.0,1,2,0,2,2,6,1,0
ENG-Premier League,1920,Liverpool,Dejan Lovren,CRO,DF,30,1989,8.6,13,8,10,3,0,7,12,58.3,5,9,6,3,10,23,42,0
ENG-Premier League,1920,Liverpool,Divock Origi,BEL,FW,24,1995,8.0,12,9,2,5,5,4,9,44.4,5,2,0,2,4,16,5,0
ENG-Premier League,1920,Liverpool,Fabinho,BRA,MF,25,1993,23.1,62,35,20,35,7,26,67,38.8,41,25,2,23,34,96,19,1
ENG-Premier League,1920,Liverpool,Georginio Wijnaldum,NED,MF,28,1990,32.6,38,20,12,21,5,10,40,25.0,30,18,4,14,17,55,34,3
ENG-Premier League,1920,Liverpool,Harvey Elliott,ENG,DF,16,2003,0.1,0,0,0,0,0,0,0,,0,0,0,0,0,0,0,0
ENG-Premier League,1920,Liverpool,James Milner,ENG,"MF,DF",33,1986,10.4,16,10,3,10,3,6,26,23.1,20,12,3,9,7,23,17,1
ENG-Premier League,1920,Liverpool,Joe Gomez,ENG,DF,22,1997,22.3,23,16,17,6,0,9,20,45.0,11,15,8,7,38,61,64,2
ENG-Premier League,1920,Liverpool,Jordan Henderson,ENG,MF,29,1990,24.9,63,41,18,33,12,22,55,40.0,33,22,4,18,30,93,21,2
ENG-Premier League,1920,Liverpool,Joël Matip,CMR,DF,27,1991,7.8,13,9,4,7,2,4,11,36.4,7,8,4,4,12,25,38,0
ENG-Premier League,1920,Liverpool,Mohamed Salah,EGY,FW,27,1992,32.0,16,6,1,4,11,5,22,22.7,17,3,1,2,8,24,2,1
ENG-Premier League,1920,Liverpool,Naby Keïta,GUI,MF,24,1995,9.1,30,14,8,16,6,11,26,42.3,15,18,0,18,10,40,4,0
ENG-Premier League,1920,Liverpool,Neco Williams,WAL,DF,18,2001,2.6,5,3,1,3,1,4,5,80.0,1,3,1,2,9,14,6,0
ENG-Premier League,1920,Liverpool,Roberto Firmino,BRA,FW,27,1991,33.2,37,19,8,14,15,10,43,23.3,33,34,3,31,7,44,11,1
ENG-Premier League,1920,Liverpool,Sadio Mané,SEN,FW,27,1992,30.5,44,32,9,20,15,13,40,32.5,27,19,0,19,13,57,11,2
ENG-Premier League,1920,Liverpool,Takumi Minamino,JPN,"FW,MF",24,1995,2.8,3,3,0,2,1,2,10,20.0,8,3,0,3,0,3,3,0
ENG-Premier League,1920,Liverpool,Trent Alexander-Arnold,ENG,DF,20,1998,35.3,55,34,35,17,3,36,78,46.2,42,27,9,18,45,100,84,3
ENG-Premier League,1920,Liverpool,Virgil van Dijk,NED,DF,28,1991,38.0,23,12,18,5,0,6,13,46.2,7,20,15,5,40,63,166,2
ENG-Premier League,1920,Liverpool,Xherdan Shaqiri,SUI,"FW,MF",27,1991,2.1,1,0,0,1,0,0,1,0.0,1,0,0,0,0,1,0,0
ENG-Premier League,1920,Manchester City,Angeliño,ESP,DF,22,1997,4.7,5,2,3,1,1,5,7,71.4,2,1,0,1,9,14,15,0
ENG-Premier League,1920,Manchester City,Aymeric Laporte,ESP,DF,25,1994,12.2,13,6,6,7,0,4,9,44.4,5,6,5,1,20,33,26,1
ENG-Premier League,1920,Manchester City,Benjamin Mendy,FRA,DF,25,1994,16.6,18,15,7,7,4,9,27,33.3,18,10,2,8,16,34,21,3
ENG-Premier League,1920,Manchester City,Bernardo Silva,POR,"FW,MF",24,1994,22.6,36,18,8,21,7,13,44,29.5,31,25,1,24,24,60,13,0
ENG-Premier League,1920,Manchester City,Claudio Bravo,CHI,GK,36,1983,3.9,0,0,0,0,0,0,0,,0,0,0,0,0,0,1,1
ENG-Premier League,1920,Manchester City,David Silva,ESP,MF,33,1986,20.3,26,14,3,15,8,10,28,35.7,18,18,3,15,13,39,5,0
ENG-Premier League,1920,Manchester City,Ederson,BRA,GK,25,1993,34.1,2,2,2,0,0,2,5,40.0,3,0,0,0,3,5,16,6
ENG-Premier League,1920,Manchester City,Eric García,ESP,DF,18,2001,8.8,6,1,4,2,0,5,9,55.6,4,2,0,2,18,24,33,0
ENG-Premier League,1920,Manchester City,Fernandinho,BRA,DF,34,1985,26.6,50,35,32,16,2,29,48,60.4,19,28,16,12,25,75,82,0
ENG-Premier League,1920,Manchester City,Gabriel Jesus,BRA,FW,22,1997,22.6,17,10,4,5,8,7,25,28.0,18,26,1,25,11,28,6,0
ENG-Premier League,1920,Manchester City,John Stones,ENG,DF,25,1994,12.5,16,10,8,7,1,3,5,60.0,2,5,3,2,9,25,32,2
ENG-Premier League,1920,Manchester City,João Cancelo,POR,DF,25,1994,13.4,40,24,21,12,7,24,40,60.0,16,9,2,7,21,61,18,0
ENG-Premier League,1920,Manchester City,Kevin De Bruyne,BEL,MF,28,1991,31.0,45,24,8,20,17,18,66,27.3,48,26,4,22,18,63,24,2
ENG-Premier League,1920,Manchester City,Kyle Walker,ENG,DF,29,1990,26.6,28,18,12,15,1,12,29,41.4,17,15,6,9,28,56,42,1
ENG-Premier League,1920,Manchester City,Leroy Sané,GER,FW,23,1996,0.1,0,0,0,0,0,0,0,,0,0,0,0,0,0,0,0
ENG-Premier League,1920,Manchester City,Nicolás Otamendi,ARG,DF,31,1988,19.1,28,14,21,6,1,16,33,48.5,17,15,9,6,21,49,76,2
ENG-Premier League,1920,Manchester City,Oleksandr Zinchenko,UKR,DF,22,1996,14.2,31,19,16,11,4,17,32,53.1,15,9,0,9,17,48,21,1
ENG-Premier League,1920,Manchester City,Phil Foden,ENG,"FW,MF",19,2000,10.0,14,10,4,6,4,6,19,31.6,13,5,0,5,6,20,2,0
ENG-Premier League,1920,Manchester City,Raheem Sterling,ENG,FW,24,1994,29.5,27,15,8,10,9,6,28,21.4,22,16,2,14,15,42,4,0
ENG-Premier League,1920,Manchester City,Riyad Mahrez,ALG,"FW,MF",28,1991,21.6,28,14,11,9,8,11,38,28.9,27,31,1,30,18,46,8,2
ENG-Premier League,1920,Manchester City,Rodri,ESP,MF,23,1996,27.6,50,30,17,25,8,23,63,36.5,40,19,5,14,26,76,35,0
ENG-Premier League,1920,Manchester City,Sergio Agüero,ARG,FW,31,1988,16.1,7,4,0,4,3,1,8,12.5,7,9,1,8,3,10,2,0
ENG-Premier League,1920,Manchester City,Tommy Doyle,ENG,MF,17,2001,0.2,0,0,0,0,0,0,1,0.0,1,0,0,0,0,0,0,0
ENG-Premier League,1920,Manchester City,İlkay Gündoğan,GER,MF,28,1990,22.4,27,16,9,11,7,9,41,22.0,32,17,5,12,31,58,13,0
ENG-Premier League,1920,Manchester Utd,Aaron Wan-Bissaka,ENG,DF,21,1997,34.1,129,80,71,50,8,64,86,74.4,22,46,13,33,66,195,83,0
ENG-Premier League,1920,Manchester Utd,Andreas Pereira,BRA,"MF,FW",23,1996,16.5,24,13,8,9,7,10,39,25.6,29,13,0,13,7,31,7,0
ENG-Premier League,1920,Manchester Utd,Angel Gomes,ENG,MF,18,2000,0.2,0,0,0,0,0,0,0,,0,1,0,1,0,0,0,0
ENG-Premier League,1920,Manchester Utd,Anthony Martial,FRA,FW,23,1995,29.2,15,12,1,4,10,1,16,6.3,15,18,1,17,5,20,17,0
ENG-Premier League,1920,Manchester Utd,Ashley Young,ENG,DF,34,1985,10.6,14,7,7,4,3,5,17,29.4,12,8,2,6,11,25,29,0
ENG-Premier League,1920,Manchester Utd,Axel Tuanzebe,COD,DF,21,1997,2.1,2,2,0,2,0,1,2,50.0,1,1,0,1,5,7,5,1
ENG-Premier League,1920,Manchester Utd,Brandon Williams,ENG,DF,18,2000,11.2,21,15,11,6,4,9,29,31.0,20,9,4,5,16,37,27,0
ENG-Premier League,1920,Manchester Utd,Bruno Fernandes,POR,MF,24,1994,13.2,22,12,9,9,4,5,38,13.2,33,6,0,6,11,33,16,0
ENG-Premier League,1920,Manchester Utd,Daniel James,WAL,FW,21,1997,25.4,20,10,5,10,5,7,45,15.6,38,23,4,19,7,27,12,0
ENG-Premier League,1920,Manchester Utd,David de Gea,ESP,GK,28,1990,38.0,0,0,0,0,0,0,0,,0,0,0,0,0,0,7,4
ENG-Premier League,1920,Manchester Utd,Diogo Dalot,POR,"DF,MF",20,1999,0.7,3,2,3,0,0,3,4,75.0,1,1,0,1,2,5,1,0
ENG-Premier League,1920,Manchester Utd,Eric Bailly,CIV,DF,25,1994,1.7,0,0,0,0,0,0,1,0.0,1,3,3,0,4,4,7,1
ENG-Premier League,1920,Manchester Utd,Fred,BRA,MF,26,1993,24.0,60,32,33,22,5,25,100,25.0,75,44,8,36,38,98,32,0
ENG-Premier League,1920,Manchester Utd,Harry Maguire,ENG,DF,26,1993,38.0,37,23,23,14,0,18,34,52.9,16,31,22,9,72,109,159,0
ENG-Premier League,1920,Manchester Utd,James Garner,ENG,MF,18,2001,0.1,0,0,0,0,0,0,1,0.0,1,0,0,0,0,0,1,0
ENG-Premier League,1920,Manchester Utd,Jesse Lingard,ENG,"MF,FW",26,1992,10.4,15,8,6,4,5,5,18,27.8,13,5,0,5,3,18,0,0
ENG-Premier League,1920,Manchester Utd,Juan Mata,ESP,"MF,FW",31,1988,8.4,7,3,1,5,1,2,7,28.6,5,5,1,4,0,7,2,0
ENG-Premier League,1920,Manchester Utd,Luke Shaw,ENG,DF,24,1995,19.3,34,18,19,11,4,19,33,57.6,14,26,6,20,24,58,56,1
ENG-Premier League,1920,Manchester Utd,Marcos Rojo,ARG,DF,29,1990,1.4,3,1,2,1,0,1,2,50.0,1,2,1,1,0,3,6,0
ENG-Premier League,1920,Manchester Utd,Marcus Rashford,ENG,FW,21,1997,29.4,13,9,1,6,6,9,23,39.1,14,23,0,23,10,23,19,0
ENG-Premier League,1920,Manchester Utd,Mason Greenwood,ENG,FW,17,2001,14.7,17,11,5,6,6,5,20,25.0,15,9,0,9,6,23,6,1
ENG-Premier League,1920,Manchester Utd,Nemanja Matić,SRB,MF,30,1988,17.6,46,24,23,19,4,20,43,46.5,23,21,8,13,22,68,28,1
ENG-Premier League,1920,Manchester Utd,Odion Ighalo,NGA,FW,30,1989,1.1,2,2,0,2,0,1,3,33.3,2,1,1,0,0,2,0,0
ENG-Premier League,1920,Manchester Utd,Paul Pogba,FRA,MF,26,1993,13.4,20,9,8,8,4,8,16,50.0,8,12,4,8,7,27,10,2
ENG-Premier League,1920,Manchester Utd,Phil Jones,ENG,DF,27,1992,1.5,2,2,1,1,0,1,1,100.0,0,2,0,2,2,4,9,1
ENG-Premier League,1920,Manchester Utd,Scott McTominay,SCO,MF,22,1996,19.7,43,22,14,25,4,17,32,53.1,15,25,5,20,31,74,34,2
ENG-Premier League,1920,Manchester Utd,Tahith Chong,NED,"FW,DF",19,1999,0.4,0,0,0,0,0,0,0,,0,0,0,0,0,0,0,0
ENG-Premier League,1920,Manchester Utd,Timothy Fosu-Mensah,NED,DF,21,1998,1.5,1,1,0,1,0,1,4,25.0,3,0,0,0,4,5,1,0
ENG-Premier League,1920,Manchester Utd,Victor Lindelöf,SWE,DF,25,1994,34.4,29,15,16,12,1,17,20,85.0,3,25,16,9,26,55,129,0
ENG-Premier League,1920,Newcastle Utd,Allan Saint-Maximin,FRA,"MF,FW",22,1997,20.7,13,8,7,4,2,4,18,22.2,14,5,2,3,9,22,6,0
ENG-Premier League,1920,Newcastle Utd,Andy Carroll,ENG,FW,30,1989,7.0,5,3,3,2,0,2,8,25.0,6,2,1,1,2,7,24,1
ENG-Premier League,1920,Newcastle Utd,Christian Atsu,GHA,"MF,FW",27,1992,8.3,10,8,5,5,0,5,14,35.7,9,19,0,19,5,15,9,0
ENG-Premier League,1920,Newcastle Utd,Ciaran Clark,IRL,DF,29,1989,13.2,20,12,18,2,0,9,15,60.0,6,18,14,4,11,31,82,0
ENG-Premier League,1920,Newcastle Utd,Danny Rose,ENG,DF,29,1990,9.6,21,12,11,8,2,12,21,57.1,9,11,4,7,10,31,14,1
ENG-Premier League,1920,Newcastle Utd,DeAndre Yedlin,USA,DF,26,1993,10.4,18,13,10,6,2,8,16,50.0,8,13,7,6,10,28,20,0
ENG-Premier League,1920,Newcastle Utd,Dwight Gayle,ENG,FW,28,1990,9.4,12,10,4,6,2,4,8,50.0,4,5,0,5,2,14,9,0
ENG-Premier League,1920,Newcastle Utd,Emil Krafth,SWE,DF,24,1994,11.3,18,12,15,2,1,9,20,45.0,11,11,8,3,8,26,45,0
ENG-Premier League,1920,Newcastle Utd,Fabian Schär,SUI,"DF,MF",27,1991,18.6,39,21,25,14,0,19,40,47.5,21,35,18,17,47,86,74,2
ENG-Premier League,1920,Newcastle Utd,Federico Fernández,ARG,DF,30,1989,29.1,42,25,30,10,2,23,46,50.0,23,41,28,13,24,66,190,2
ENG-Premier League,1920,Newcastle Utd,Florian Lejeune,FRA,DF,28,1991,4.9,8,2,6,2,0,4,7,57.1,3,6,2,4,10,18,15,2
ENG-Premier League,1920,Newcastle Utd,Isaac Hayden,ENG,MF,24,1995,24.7,55,27,33,17,5,20,50,40.0,30,24,7,17,38,93,38,0
ENG-Premier League,1920,Newcastle Utd,Jamaal Lascelles,ENG,DF,25,1993,23.1,14,3,10,4,0,4,9,44.4,5,23,20,3,28,42,116,1
ENG-Premier League,1920,Newcastle Utd,Javier Manquillo,ESP,DF,25,1994,17.8,39,26,27,8,4,24,38,63.2,14,14,2,12,18,57,56,0
ENG-Premier League,1920,Newcastle Utd,Jetro Willems,NED,DF,25,1994,16.6,37,19,29,6,2,18,39,46.2,21,20,5,15,17,54,42,1
ENG-Premier League,1920,Newcastle Utd,Joelinton,BRA,FW,22,1996,29.8,34,20,7,22,5,9,32,28.1,23,32,6,26,11,45,30,0
ENG-Premier League,1920,Newcastle Utd,Jonjo Shelvey,ENG,MF,27,1992,23.5,29,19,17,12,0,11,42,26.2,31,14,5,9,23,52,38,0
ENG-Premier League,1920,Newcastle Utd,Kelland Watts,ENG,DF,19,1999,0.2,1,0,1,0,0,1,1,100.0,0,0,0,0,0,1,0,0
ENG-Premier League,1920,Newcastle Utd,Ki Sung-yueng,KOR,MF,30,1989,1.5,1,1,0,1,0,1,3,33.3,2,1,0,1,3,4,2,0
ENG-Premier League,1920,Newcastle Utd,Martin Dúbravka,SVK,GK,30,1989,38.0,1,1,1,0,0,1,2,50.0,1,2,0,2,1,2,17,5
ENG-Premier League,1920,Newcastle Utd,Matt Ritchie,SCO,"DF,MF",29,1989,14.6,22,15,9,10,3,3,15,20.0,12,20,5,15,14,36,31,1
ENG-Premier League,1920,Newcastle Utd,Matthew Longstaff,ENG,MF,19,2000,6.4,3,1,2,1,0,3,14,21.4,11,4,1,3,5,8,3,0
ENG-Premier League,1920,Newcastle Utd,Miguel Almirón,PAR,"MF,FW",25,1994,33.6,60,39,32,20,8,19,52,36.5,33,25,1,24,31,91,25,0
ENG-Premier League,1920,Newcastle Utd,Nabil Bentaleb,ALG,MF,24,1994,8.3,23,13,14,9,0,7,25,28.0,18,9,2,7,19,42,9,1
ENG-Premier League,1920,Newcastle Utd,Paul Dummett,WAL,DF,27,1991,13.6,27,17,19,7,1,21,27,77.8,6,23,9,14,23,50,69,0
ENG-Premier League,1920,Newcastle Utd,Sean Longstaff,ENG,MF,21,1997,15.3,35,19,17,16,2,20,50,40.0,30,23,5,18,19,54,20,2
ENG-Premier League,1920,Newcastle Utd,Valentino Lazaro,AUT,"DF,MF",23,1996,5.3,13,9,11,2,0,11,18,61.1,7,2,0,2,3,16,4,0
ENG-Premier League,1920,Newcastle Utd,Yoshinori Mutō,JPN,"MF,FW",27,1992,2.4,3,2,1,2,0,1,2,50.0,1,0,0,0,0,3,0,0
ENG-Premier League,1920,Norwich City,Adam Idah,IRL,"FW,MF",18,2001,2.5,2,2,1,0,1,2,3,66.7,1,4,0,4,0,2,1,0
ENG-Premier League,1920,Norwich City,Akin Famewo,ENG,MF,20,1998,0.0,0,0,0,0,0,0,0,,0,0,0,0,0,0,0,0
ENG-Premier League,1920,Norwich City,Alexander Tettey,NOR,"MF,DF",33,1986,26.0,23,18,7,16,0,11,39,28.2,28,20,9,11,43,66,72,1
ENG-Premier League,1920,Norwich City,Ben Godfrey,ENG,DF,21,1998,29.4,22,14,18,3,1,10,18,55.6,8,41,37,4,25,47,152,3
ENG-Premier League,1920,Norwich City,Christoph Zimmermann,GER,DF,26,1993,15.9,32,21,26,6,0,21,30,70.0,9,22,18,4,19,51,87,2
ENG-Premier League,1920,Norwich City,Dennis Srbeny,GER,"MF,FW",25,1994,0.5,5,5,3,2,0,1,3,33.3,2,1,0,1,0,5,1,0
ENG-Premier League,1920,Norwich City,Emi Buendía,ARG,"FW,MF",22,1996,27.4,82,39,57,21,4,38,118,32.2,80,58,5,53,23,105,32,2
ENG-Premier League,1920,Norwich City,Grant Hanley,SCO,DF,27,1991,14.0,24,15,17,7,0,8,14,57.1,6,25,18,7,31,55,77,1
ENG-Premier League,1920,Norwich City,Ibrahim Amadou,FRA,"DF,MF",26,1993,8.4,18,11,9,8,1,3,11,27.3,8,8,5,3,16,34,55,1
ENG-Premier League,1920,Norwich City,Jamal Lewis,NIR,DF,21,1998,25.6,51,35,42,6,3,22,36,61.1,14,27,12,15,25,76,68,0
ENG-Premier League,1920,Norwich City,Jordan Thomas,ENG,FW,18,2001,0.0,0,0,0,0,0,0,0,,0,0,0,0,0,0,0,0
ENG-Premier League,1920,Norwich City,Josh Martin,ENG,"FW,MF",17,2001,0.4,1,0,0,0,1,0,0,,0,1,0,1,1,2,0,0
ENG-Premier League,1920,Norwich City,Josip Drmić,SUI,FW,26,1992,7.2,3,2,1,2,0,0,8,0.0,8,6,0,6,1,4,5,1
ENG-Premier League,1920,Norwich City,Kenny McLean,SCO,MF,27,1992,33.0,44,29,20,18,6,14,42,33.3,28,32,7,25,38,82,67,2
ENG-Premier League,1920,Norwich City,Lukas Rupp,GER,"FW,MF",28,1991,7.7,15,9,7,5,3,5,17,29.4,12,11,0,11,15,30,4,0
ENG-Premier League,1920,Norwich City,Marco Stiepermann,GER,MF,28,1991,13.1,20,8,8,9,3,5,21,23.8,16,11,3,8,5,25,16,0
ENG-Premier League,1920,Norwich City,Mario Vrančić,BIH,MF,30,1989,7.1,27,16,14,11,2,16,27,59.3,11,9,0,9,10,37,4,2
ENG-Premier League,1920,Norwich City,Max Aarons,ENG,DF,19,2000,36.0,48,30,33,9,6,18,36,50.0,18,46,29,17,37,85,97,1
ENG-Premier League,1920,Norwich City,Michael McGovern,NIR,GK,35,1984,1.8,0,0,0,0,0,0,0,,0,0,0,0,0,0,1,1
ENG-Premier League,1920,Norwich City,Moritz Leitner,GER,MF,26,1992,7.6,16,9,8,7,1,9,25,36.0,16,14,4,10,9,25,10,1
ENG-Premier League,1920,Norwich City,Ondrej Duda,SVK,MF,24,1994,8.0,18,11,9,6,3,7,16,43.8,9,10,2,8,6,24,8,0
ENG-Premier League,1920,Norwich City,Onel Hernández,CUB,"FW,MF",26,1993,15.4,27,19,13,11,3,9,31,29.0,22,12,1,11,19,46,10,0
ENG-Premier League,1920,Norwich City,Patrick Roberts,ENG,"FW,MF",22,1997,0.3,0,0,0,0,0,0,0,,0,0,0,0,0,0,0,0
ENG-Premier League,1920,Norwich City,Ralf Fährmann,GER,GK,30,1988,0.2,0,0,0,0,0,0,0,,0,0,0,0,0,0,0,0
ENG-Premier League,1920,Norwich City,Sam Byram,ENG,DF,25,1993,14.4,40,22,24,11,5,18,37,48.6,19,16,8,8,26,66,73,0
ENG-Premier League,1920,Norwich City,Teemu Pukki,FIN,FW,29,1990,32.1,12,6,3,5,4,1,23,4.3,22,13,0,13,6,18,7,0
ENG-Premier League,1920,Norwich City,Tim Krul,NED,GK,31,1988,36.0,0,0,0,0,0,0,1,0.0,1,2,0,2,1,1,13,1
ENG-Premier League,1920,Norwich City,Timm Klose,SUI,DF,31,1988,6.5,8,2,5,2,1,7,11,63.6,4,6,6,0,7,15,29,0
ENG-Premier League,1920,Norwich City,Todd Cantwell,ENG,"FW,MF",21,1998,27.7,51,31,19,27,5,26,73,35.6,47,38,2,36,18,69,35,1
ENG-Premier League,1920,Norwich City,Tom Trybull,GER,MF,26,1993,12.6,39,25,15,18,6,16,60,26.7,44,20,5,15,16,55,35,0
ENG-Premier League,1920,Sheffield Utd,Ben Osborn,ENG,"MF,DF",24,1994,6.6,15,10,11,3,1,3,16,18.8,13,6,1,5,6,21,7,0
ENG-Premier League,1920,Sheffield Utd,Billy Sharp,ENG,FW,33,1986,11.7,6,5,2,1,3,1,6,16.7,5,2,0,2,1,7,2,0
ENG-Premier League,1920,Sheffield Utd,Callum Robinson,IRL,"FW,MF",24,1995,7.5,6,3,2,2,2,2,7,28.6,5,3,0,3,7,13,3,0
ENG-Premier League,1920,Sheffield Utd,Chris Basham,ENG,DF,31,1988,36.0,85,48,58,20,7,48,81,59.3,33,38,15,23,77,162,173,1
ENG-Premier League,1920,Sheffield Utd,David McGoldrick,IRL,FW,31,1987,20.2,41,26,9,24,8,5,20,25.0,15,14,2,12,3,44,23,0
ENG-Premier League,1920,Sheffield Utd,Dean Henderson,ENG,GK,22,1997,36.0,0,0,0,0,0,0,0,,0,0,0,0,1,1,13,1
ENG-Premier League,1920,Sheffield Utd,Enda Stevens,IRL,DF,29,1990,37.2,81,46,48,26,7,42,96,43.8,54,27,8,19,35,116,71,3
ENG-Premier League,1920,Sheffield Utd,George Baldock,GRE,DF,26,1993,38.0,62,43,35,17,10,27,47,57.4,20,26,3,23,34,96,83,3
ENG-Premier League,1920,Sheffield Utd,Jack O'Connell,ENG,DF,25,1994,32.4,23,14,15,6,2,10,20,50.0,10,38,17,21,42,65,154,1
ENG-Premier League,1920,Sheffield Utd,Jack Robinson,ENG,DF,25,1993,5.6,10,5,5,5,0,1,6,16.7,5,12,5,7,8,18,24,0
ENG-Premier League,1920,Sheffield Utd,Jack Rodwell,ENG,MF,28,1991,0.2,0,0,0,0,0,0,0,,0,0,0,0,0,0,1,0
ENG-Premier League,1920,Sheffield Utd,John Egan,IRL,DF,26,1992,35.4,44,27,34,10,0,25,45,55.6,20,39,27,12,58,102,171,4
ENG-Premier League,1920,Sheffield Utd,John Fleck,SCO,MF,27,1991,28.0,36,25,13,14,9,22,64,34.4,42,25,3,22,24,60,26,0
ENG-Premier League,1920,Sheffield Utd,John Lundstram,ENG,MF,25,1994,27.3,46,30,18,21,7,21,65,32.3,44,18,4,14,33,79,46,1
ENG-Premier League,1920,Sheffield Utd,Kieron Freeman,WAL,FW,27,1992,0.1,0,0,0,0,0,0,0,,0,0,0,0,0,0,0,0
ENG-Premier League,1920,Sheffield Utd,Leon Clarke,ENG,"FW,MF",34,1985,0.4,0,0,0,0,0,0,0,,0,0,0,0,0,0,2,0
ENG-Premier League,1920,Sheffield Utd,Luke Freeman,ENG,MF,27,1992,4.1,6,4,2,2,2,2,8,25.0,6,1,0,1,10,16,6,0
ENG-Premier League,1920,Sheffield Utd,Lys Mousset,FRA,FW,23,1996,13.8,9,5,0,5,4,3,7,42.9,4,3,0,3,4,13,2,0
ENG-Premier League,1920,Sheffield Utd,Muhamed Bešić,BIH,MF,26,1992,2.8,8,6,4,4,0,2,5,40.0,3,4,0,4,1,9,6,0
ENG-Premier League,1920,Sheffield Utd,Oliver McBurnie,SCO,FW,23,1996,23.5,37,22,6,27,4,11,40,27.5,29,25,3,22,15,52,43,0
ENG-Premier League,1920,Sheffield Utd,Oliver Norwood,NIR,MF,28,1991,34.3,66,37,35,24,7,28,97,28.9,69,34,12,22,47,113,40,1
ENG-Premier League,1920,Sheffield Utd,Phil Jagielka,ENG,DF,36,1982,2.7,5,4,3,2,0,1,3,33.3,2,5,5,0,4,9,19,0
ENG-Premier League,1920,Sheffield Utd,Ravel Morrison,JAM,MF,26,1993,0.1,0,0,0,0,0,0,0,,0,0,0,0,0,0,0,0
ENG-Premier League,1920,Sheffield Utd,Richairo Živković,CUW,FW,22,1996,1.2,2,2,0,2,0,1,2,50.0,1,1,0,1,0,2,0,0
ENG-Premier League,1920,Sheffield Utd,Sander Berge,NOR,MF,21,1998,10.5,22,15,3,14,5,5,10,50.0,5,15,1,14,10,32,16,0
ENG-Premier League,1920,Sheffield Utd,Simon Moore,ENG,GK,29,1990,2.0,1,0,1,0,0,1,1,100.0,0,0,0,0,0,1,0,1
ENG-Premier League,1920,Southampton,Alex McCarthy,ENG,GK,29,1989,28.0,1,1,1,0,0,1,1,100.0,0,1,0,1,0,1,11,3
ENG-Premier League,1920,Southampton,Angus Gunn,SCO,GK,23,1996,10.0,1,1,1,0,0,1,3,33.3,2,0,0,0,0,1,1,0
ENG-Premier League,1920,Southampton,Che Adams,SCO,FW,23,1996,12.3,6,4,1,5,0,1,4,25.0,3,9,1,8,2,8,10,0
ENG-Premier League,1920,Southampton,Cédric Soares,POR,DF,27,1991,14.5,45,26,19,24,2,25,41,61.0,16,18,4,14,19,64,51,0
ENG-Premier League,1920,Southampton,Danny Ings,ENG,FW,27,1992,31.2,42,25,16,16,10,13,67,19.4,54,62,4,58,9,51,30,1
ENG-Premier League,1920,Southampton,Jack Stephens,ENG,DF,25,1994,27.2,44,27,30,13,1,24,46,52.2,22,38,22,16,31,75,120,2
ENG-Premier League,1920,Southampton,Jake Vokins,ENG,DF,19,2000,1.0,2,2,0,0,2,1,1,100.0,0,0,0,0,0,2,1,0
ENG-Premier League,1920,Southampton,James Ward-Prowse,ENG,"MF,DF",24,1994,38.0,92,48,39,39,14,39,94,41.5,55,48,14,34,60,152,75,1
ENG-Premier League,1920,Southampton,Jan Bednarek,POL,DF,23,1996,34.0,65,38,41,18,6,31,61,50.8,30,44,23,21,77,142,198,4
ENG-Premier League,1920,Southampton,Jannik Vestergaard,DEN,DF,26,1992,16.6,19,12,14,5,0,11,28,39.3,17,15,9,6,26,45,99,2
ENG-Premier League,1920,Southampton,Kevin Danso,AUT,DF,20,1998,3.1,6,4,3,3,0,4,7,57.1,3,7,3,4,2,8,7,0
ENG-Premier League,1920,Southampton,Kyle Walker-Peters,ENG,DF,22,1997,7.8,13,8,5,6,2,6,16,37.5,10,10,3,7,14,27,21,1
ENG-Premier League,1920,Southampton,Maya Yoshida,JPN,DF,30,1988,6.2,8,5,4,1,3,3,7,42.9,4,6,2,4,4,12,27,1
ENG-Premier League,1920,Southampton,Michael Obafemi,IRL,FW,19,2000,7.4,7,3,1,3,3,2,14,14.3,12,3,0,3,6,13,0,0
ENG-Premier League,1920,Southampton,Moussa Djenepo,MLI,"MF,DF",21,1998,10.3,27,21,13,9,5,11,21,52.4,10,15,1,14,9,36,9,0
ENG-Premier League,1920,Southampton,Nathan Redmond,ENG,"MF,FW",25,1994,30.7,49,29,17,23,9,21,57,36.8,36,39,2,37,16,65,16,0
ENG-Premier League,1920,Southampton,Nathan Tella,NGA,FW,20,1999,0.0,0,0,0,0,0,0,0,,0,0,0,0,0,0,0,0
ENG-Premier League,1920,Southampton,Oriol Romeu,ESP,MF,27,1991,20.7,55,35,23,30,2,27,75,36.0,48,35,13,22,34,89,32,0
ENG-Premier League,1920,Southampton,Pierre Højbjerg,DEN,MF,23,1995,30.6,80,49,34,38,8,39,91,42.9,52,44,5,39,46,126,54,2
ENG-Premier League,1920,Southampton,Ryan Bertrand,ENG,DF,29,1989,30.5,47,29,22,15,10,26,58,44.8,32,27,12,15,37,84,31,1
ENG-Premier League,1920,Southampton,Shane Long,IRL,FW,32,1987,15.5,19,10,5,8,6,7,19,36.8,12,12,0,12,4,23,16,0
ENG-Premier League,1920,Southampton,Sofiane Boufal,MAR,"MF,FW",25,1993,8.5,16,8,6,5,5,6,15,40.0,9,17,0,17,4,20,1,0
ENG-Premier League,1920,Southampton,Stuart Armstrong,SCO,MF,27,1992,19.1,32,19,19,11,2,9,38,23.7,29,22,4,18,11,43,23,1
ENG-Premier League,1920,Southampton,William Smallbone,IRL,MF,19,2000,4.4,10,5,2,8,0,5,10,50.0,5,7,1,6,1,11,2,0
ENG-Premier League,1920,Southampton,Yan Valery,TUN,DF,20,1999,8.7,20,7,9,7,4,11,19,57.9,8,9,1,8,13,33,32,2
ENG-Premier League,1920,Tottenham,Ben Davies,WAL,DF,26,1993,15.9,28,15,13,11,4,7,21,33.3,14,28,12,16,22,50,47,0
ENG-Premier League,1920,Tottenham,Christian Eriksen,DEN,"MF,FW",27,1992,12.2,19,9,10,8,1,7,24,29.2,17,10,1,9,12,31,16,0
ENG-Premier League,1920,Tottenham,Danny Rose,ENG,DF,29,1990,9.9,18,11,6,10,2,9,20,45.0,11,14,6,8,8,26,34,2
ENG-Premier League,1920,Tottenham,Davinson Sánchez,COL,DF,23,1996,27.0,44,27,32,12,0,22,44,50.0,22,40,28,12,34,78,128,5
ENG-Premier League,1920,Tottenham,Dele Alli,ENG,"MF,FW",23,1996,20.5,34,16,11,20,3,13,37,35.1,24,35,3,32,17,51,17,2
ENG-Premier League,1920,Tottenham,Eric Dier,ENG,"DF,MF",25,1994,14.9,21,12,10,10,1,10,20,50.0,10,14,9,5,21,42,65,0
ENG-Premier League,1920,Tottenham,Gedson Fernandes,POR,"MF,DF",20,1999,0.8,2,0,2,0,0,0,2,0.0,2,2,0,2,1,3,0,0
ENG-Premier League,1920,Tottenham,Georges-Kévin N'Koudou,CMR,FW,24,1995,0.0,0,0,0,0,0,0,1,0.0,1,0,0,0,0,0,0,0
ENG-Premier League,1920,Tottenham,Giovani Lo Celso,ARG,"MF,FW",23,1996,16.6,51,29,12,33,6,12,59,20.3,47,20,4,16,9,60,19,0
ENG-Premier League,1920,Tottenham,Harry Kane,ENG,FW,26,1993,28.7,18,12,3,12,3,4,17,23.5,13,17,7,10,6,24,30,0
ENG-Premier League,1920,Tottenham,Harry Winks,ENG,MF,23,1996,24.7,40,24,18,20,2,17,54,31.5,37,27,8,19,36,76,32,1
ENG-Premier League,1920,Tottenham,Hugo Lloris,FRA,GK,32,1986,20.1,0,0,0,0,0,0,0,,0,0,0,0,1,1,3,2
ENG-Premier League,1920,Tottenham,Jan Vertonghen,BEL,DF,32,1987,18.3,40,24,25,14,1,20,31,64.5,11,18,10,8,33,73,68,0
ENG-Premier League,1920,Tottenham,Japhet Tanganga,ENG,DF,20,1999,5.8,17,9,10,6,1,10,17,58.8,7,7,6,1,11,28,31,2
ENG-Premier League,1920,Tottenham,Juan Foyth,ARG,DF,21,1998,0.8,7,3,5,2,0,3,4,75.0,1,1,0,1,1,8,3,1
ENG-Premier League,1920,Tottenham,Kyle Walker-Peters,ENG,DF,22,1997,2.7,8,5,8,0,0,5,9,55.6,4,4,2,2,3,11,5,1
ENG-Premier League,1920,Tottenham,Lucas Moura,BRA,"FW,MF",26,1992,24.9,57,33,25,22,10,16,58,27.6,42,29,2,27,15,72,27,0
ENG-Premier League,1920,Tottenham,Moussa Sissoko,FRA,MF,29,1989,27.2,39,25,25,12,2,20,48,41.7,28,19,4,15,27,66,43,2
ENG-Premier League,1920,Tottenham,Oliver Skipp,ENG,MF,18,2000,0.9,2,2,0,2,0,1,4,25.0,3,3,2,1,0,2,0,0
ENG-Premier League,1920,Tottenham,Paulo Gazzaniga,ARG,GK,27,1992,17.9,0,0,0,0,0,0,0,,0,0,0,0,1,1,4,1
ENG-Premier League,1920,Tottenham,Ryan Sessegnon,ENG,"DF,FW",19,2000,3.8,6,4,2,4,0,3,6,50.0,3,0,0,0,3,9,12,0
ENG-Premier League,1920,Tottenham,Serge Aurier,CIV,DF,26,1992,30.0,93,69,58,27,8,39,69,56.5,30,38,6,32,47,140,98,2
ENG-Premier League,1920,Tottenham,Son Heung-min,KOR,FW,27,1992,27.5,23,15,10,11,2,9,57,15.8,48,23,0,23,19,42,18,1
ENG-Premier League,1920,Tottenham,Steven Bergwijn,NED,"FW,MF",21,1997,7.8,10,6,3,6,1,4,12,33.3,8,12,0,12,1,11,5,0
ENG-Premier League,1920,Tottenham,Tanguy Ndombele,FRA,MF,22,1996,11.2,24,16,10,13,1,9,22,40.9,13,20,3,17,14,38,7,0
ENG-Premier League,1920,Tottenham,Toby Alderweireld,BEL,DF,30,1989,32.9,40,29,24,13,3,11,24,45.8,13,48,32,16,31,71,172,2
ENG-Premier League,1920,Tottenham,Troy Parrott,IRL,FW,17,2002,0.1,0,0,0,0,0,0,0,,0,0,0,0,0,0,0,0
ENG-Premier League,1920,Tottenham,Victor Wanyama,KEN,MF,28,1991,0.3,0,0,0,0,0,0,0,,0,0,0,0,0,0,0,0
ENG-Premier League,1920,Tottenham,Érik Lamela,ARG,"MF,FW",27,1992,13.5,24,20,9,13,2,2,21,9.5,19,12,3,9,8,32,10,0
ENG-Premier League,1920,Watford,Abdoulaye Doucouré,MLI,MF,26,1993,35.1,64,30,29,29,6,16,57,28.1,41,46,8,38,31,95,32,0
ENG-Premier League,1920,Watford,Adam Masina,MAR,DF,25,1994,20.2,38,22,24,11,3,14,37,37.8,23,26,12,14,28,66,66,0
ENG-Premier League,1920,Watford,Adrian Mariappa,JAM,DF,32,1986,16.8,20,14,15,4,1,11,30,36.7,19,22,7,15,11,31,73,0
ENG-Premier League,1920,Watford,Andre Gray,JAM,FW,28,1991,8.4,4,3,0,2,2,1,3,33.3,2,4,1,3,1,5,2,0
ENG-Premier League,1920,Watford,Ben Foster,ENG,GK,36,1983,38.0,1,0,1,0,0,1,3,33.3,2,1,0,1,0,1,16,2
ENG-Premier League,1920,Watford,Christian Kabasele,BEL,DF,28,1991,25.0,37,24,26,11,0,17,32,53.1,15,31,23,8,36,73,127,0
ENG-Premier League,1920,Watford,Craig Cathcart,NIR,DF,30,1989,27.6,41,26,25,15,1,10,24,41.7,14,19,16,3,25,66,136,1
ENG-Premier League,1920,Watford,Craig Dawson,ENG,DF,29,1990,26.2,29,18,16,13,0,17,31,54.8,14,41,32,9,34,63,116,0
ENG-Premier League,1920,Watford,Danny Welbeck,ENG,"FW,MF",28,1990,9.1,14,6,6,5,3,3,11,27.3,8,12,1,11,5,19,7,0
ENG-Premier League,1920,Watford,Daryl Janmaat,NED,DF,30,1989,6.7,14,10,8,6,0,6,13,46.2,7,7,2,5,7,21,23,0
ENG-Premier League,1920,Watford,Dimitri Foulquier,FRA,"DF,MF",26,1993,0.7,1,0,1,0,0,0,0,,0,1,0,1,2,3,2,0
ENG-Premier League,1920,Watford,Domingos Quina,POR,"MF,FW",19,1999,0.2,2,0,1,1,0,1,2,50.0,1,3,0,3,0,2,0,0
ENG-Premier League,1920,Watford,Gerard Deulofeu,ESP,FW,25,1994,23.3,33,16,18,9,6,12,59,20.3,47,10,0,10,25,58,6,0
ENG-Premier League,1920,Watford,Ignacio Pussetto,ARG,"FW,MF",23,1995,0.8,7,4,4,2,1,3,8,37.5,5,2,1,1,3,10,4,0
ENG-Premier League,1920,Watford,Isaac Success,NGA,"FW,MF",23,1996,0.8,0,0,0,0,0,0,0,,0,0,0,0,1,1,0,0
ENG-Premier League,1920,Watford,Ismaila Sarr,SEN,"FW,MF",21,1998,22.5,11,10,5,2,4,5,23,21.7,18,9,1,8,18,29,10,0
ENG-Premier League,1920,Watford,José Holebas,GRE,DF,35,1984,11.4,26,15,19,7,0,9,28,32.1,19,11,4,7,3,29,33,0
ENG-Premier League,1920,Watford,João Pedro,BRA,"FW,MF",17,2001,0.3,0,0,0,0,0,0,0,,0,0,0,0,0,0,0,0
ENG-Premier League,1920,Watford,Kiko Femenía,ESP,DF,28,1991,24.9,68,38,49,17,2,43,80,53.8,37,16,2,14,36,104,49,0
ENG-Premier League,1920,Watford,Nathaniel Chalobah,ENG,MF,24,1994,10.3,30,11,13,13,4,12,27,44.4,15,10,4,6,18,48,20,0
ENG-Premier League,1920,Watford,Roberto Pereyra,ARG,"FW,MF",28,1991,18.3,20,8,11,7,2,9,28,32.1,19,21,0,21,14,34,12,1
ENG-Premier League,1920,Watford,Sebastian Prödl,AUT,DF,32,1987,0.6,0,0,0,0,0,0,0,,0,0,0,0,0,0,4,0
ENG-Premier League,1920,Watford,Tom Cleverley,ENG,MF,29,1989,10.8,28,15,8,14,6,9,36,25.0,27,13,1,12,10,38,15,0
ENG-Premier League,1920,Watford,Troy Deeney,ENG,FW,31,1988,24.7,19,12,6,10,3,6,29,20.7,23,13,1,12,11,30,27,0
ENG-Premier League,1920,Watford,Will Hughes,ENG,MF,24,1995,25.0,75,47,24,41,10,25,67,37.3,42,48,8,40,37,112,28,0
ENG-Premier League,1920,Watford,Étienne Capoue,FRA,MF,31,1988,29.2,75,40,38,30,7,37,85,43.5,48,30,11,19,68,143,61,0
ENG-Premier League,1920,West Ham,Aaron Cresswell,ENG,DF,29,1989,30.3,43,26,21,18,4,23,46,50.0,23,33,10,23,35,78,75,2
ENG-Premier League,1920,West Ham,Albian Ajeti,SUI,FW,22,1997,1.5,1,0,0,0,1,0,0,,0,0,0,0,0,1,0,0
ENG-Premier League,1920,West Ham,Andriy Yarmolenko,UKR,"MF,FW",29,1989,11.0,13,8,5,6,2,5,20,25.0,15,3,1,2,6,19,4,0
ENG-Premier League,1920,West Ham,Angelo Ogbonna,ITA,DF,31,1988,31.0,38,24,20,14,4,18,32,56.3,14,50,32,18,27,65,134,1
ENG-Premier League,1920,West Ham,Arthur Masuaku,COD,DF,25,1993,10.4,41,23,24,13,4,23,39,59.0,16,19,5,14,14,55,23,0
ENG-Premier League,1920,West Ham,Ben Johnson,ENG,DF,19,2000,3.0,8,4,7,1,0,7,10,70.0,3,5,2,3,3,11,11,0
ENG-Premier League,1920,West Ham,Carlos Sánchez,COL,MF,33,1986,1.3,1,0,0,1,0,1,1,100.0,0,1,0,1,2,3,1,0
ENG-Premier League,1920,West Ham,Darren Randolph,IRL,GK,32,1987,2.0,0,0,0,0,0,0,0,,0,0,0,0,0,0,2,0
ENG-Premier League,1920,West Ham,David Martin,ENG,GK,33,1986,4.8,0,0,0,0,0,0,0,,0,0,0,0,0,0,1,1
ENG-Premier League,1920,West Ham,Declan Rice,ENG,MF,20,1999,38.0,116,60,64,48,4,47,98,48.0,51,41,9,32,77,193,55,0
ENG-Premier League,1920,West Ham,Fabián Balbuena,PAR,DF,27,1991,13.1,17,12,13,3,1,9,25,36.0,16,15,5,10,26,43,75,3
ENG-Premier League,1920,West Ham,Felipe Anderson,BRA,"MF,FW",26,1993,16.6,46,32,20,21,5,11,47,23.4,36,19,1,18,22,68,11,0
ENG-Premier League,1920,West Ham,Issa Diop,FRA,DF,22,1997,30.7,27,15,18,9,0,16,25,64.0,9,37,21,16,47,74,166,2
ENG-Premier League,1920,West Ham,Jack Wilshere,ENG,MF,27,1992,2.4,1,0,1,0,0,0,4,0.0,4,3,0,3,1,2,0,0
ENG-Premier League,1920,West Ham,Jarrod Bowen,ENG,"FW,MF",22,1996,10.2,19,15,7,9,3,4,17,23.5,13,6,0,6,16,35,8,0
ENG-Premier League,1920,West Ham,Javier Hernández,MEX,FW,31,1988,1.2,0,0,0,0,0,0,1,0.0,1,0,0,0,1,1,0,0
ENG-Premier League,1920,West Ham,Jeremy Ngakia,ENG,DF,18,2000,4.9,15,7,10,5,0,9,21,42.9,12,6,1,5,7,22,16,0
ENG-Premier League,1920,West Ham,Manuel Lanzini,ARG,"MF,FW",26,1993,15.3,14,9,6,6,2,7,39,17.9,32,9,1,8,10,24,3,0
ENG-Premier League,1920,West Ham,Mark Noble,ENG,MF,32,1987,29.7,52,30,19,28,5,22,64,34.4,42,20,6,14,20,72,10,1
ENG-Premier League,1920,West Ham,Michail Antonio,JAM,FW,29,1990,19.6,13,9,5,4,4,4,14,28.6,10,17,2,15,9,22,5,0
ENG-Premier League,1920,West Ham,Nathan Holland,ENG,MF,21,1998,0.4,3,1,2,1,0,0,0,,0,1,0,1,0,3,0,0
ENG-Premier League,1920,West Ham,Pablo Fornals,ESP,"MF,FW",23,1996,24.1,46,28,21,18,7,19,64,29.7,45,35,1,34,25,71,15,0
ENG-Premier League,1920,West Ham,Pablo Zabaleta,ARG,DF,34,1985,6.6,18,10,12,5,1,6,13,46.2,7,5,3,2,14,32,21,0
ENG-Premier League,1920,West Ham,Robert Snodgrass,SCO,"MF,FW",31,1987,16.8,29,16,17,10,2,13,44,29.5,31,12,1,11,4,33,11,0
ENG-Premier League,1920,West Ham,Roberto,ESP,GK,33,1986,7.6,0,0,0,0,0,0,0,,0,0,0,0,0,0,2,2
ENG-Premier League,1920,West Ham,Ryan Fredericks,ENG,DF,26,1992,24.9,82,56,59,18,5,41,64,64.1,23,20,10,10,24,106,73,1
ENG-Premier League,1920,West Ham,Sébastien Haller,CIV,FW,25,1994,25.2,22,15,8,10,4,3,30,10.0,27,19,5,14,8,30,27,0
ENG-Premier League,1920,West Ham,Tomáš Souček,CZE,MF,24,1995,11.6,29,15,13,15,1,10,23,43.5,13,7,1,6,22,51,35,0
ENG-Premier League,1920,West Ham,Łukasz Fabiański,POL,GK,34,1985,23.5,2,2,2,0,0,2,4,50.0,2,0,0,0,1,3,5,3
ENG-Premier League,1920,Wolves,Adama Traoré,ESP,"FW,DF",23,1996,28.9,33,21,6,14,13,8,23,34.8,15,19,3,16,13,46,14,2
ENG-Premier League,1920,Wolves,Bruno Jordão,POR,FW,20,1998,0.1,0,0,0,0,0,0,0,,0,1,0,1,0,0,0,0
ENG-Premier League,1920,Wolves,Conor Coady,ENG,DF,26,1993,38.0,36,23,30,6,0,15,30,50.0,15,22,15,7,28,64,119,2
ENG-Premier League,1920,Wolves,Daniel Podence,POR,"FW,MF",23,1995,3.2,3,3,2,0,1,0,2,0.0,2,4,1,3,2,5,1,0
ENG-Premier League,1920,Wolves,Diogo Jota,POR,FW,22,1996,25.4,28,15,16,10,2,12,48,25.0,36,17,0,17,9,37,10,2
ENG-Premier League,1920,Wolves,Jesús Vallejo,ESP,DF,22,1997,1.8,1,1,1,0,0,1,2,50.0,1,4,3,1,2,3,8,1
ENG-Premier League,1920,Wolves,Jonny Castro,ESP,"MF,DF",25,1994,32.1,91,55,54,26,11,29,82,35.4,53,45,10,35,53,144,45,2
ENG-Premier League,1920,Wolves,João Moutinho,POR,MF,32,1986,34.5,93,50,43,41,9,46,139,33.1,93,43,13,30,50,143,18,1
ENG-Premier League,1920,Wolves,Leander Dendoncker,BEL,"MF,DF",24,1995,31.1,68,31,41,19,8,28,67,41.8,39,39,12,27,38,106,64,2
ENG-Premier League,1920,Wolves,Matt Doherty,IRL,"MF,DF",27,1992,31.5,55,29,34,17,4,27,41,65.9,14,34,4,30,40,95,52,1
ENG-Premier League,1920,Wolves,Max Kilman,ENG,DF,22,1997,2.1,4,2,1,3,0,2,2,100.0,0,1,1,0,4,8,7,0
ENG-Premier League,1920,Wolves,Morgan Gibbs-White,ENG,"MF,FW",19,2000,1.4,0,0,0,0,0,0,0,,0,0,0,0,2,2,0,0
ENG-Premier League,1920,Wolves,Patrick Cutrone,ITA,FW,21,1998,3.3,4,2,2,1,1,1,5,20.0,4,1,1,0,2,6,1,0
ENG-Premier League,1920,Wolves,Pedro Neto,POR,"FW,MF",19,2000,10.4,9,4,3,6,0,4,15,26.7,11,2,0,2,6,15,4,0
ENG-Premier League,1920,Wolves,Raúl Jiménez,MEX,FW,28,1991,36.0,20,12,6,10,4,3,31,9.7,28,26,0,26,16,36,34,1
ENG-Premier League,1920,Wolves,Romain Saïss,MAR,DF,29,1990,30.1,55,38,37,15,3,32,46,69.6,14,31,16,15,55,110,127,3
ENG-Premier League,1920,Wolves,Rui Patrício,POR,GK,31,1988,38.0,0,0,0,0,0,0,2,0.0,2,2,0,2,2,2,5,2
ENG-Premier League,1920,Wolves,Ryan Bennett,ENG,DF,29,1990,6.7,4,2,4,0,0,2,6,33.3,4,14,8,6,9,13,29,0
ENG-Premier League,1920,Wolves,Rúben Neves,POR,MF,22,1997,34.0,62,33,27,32,3,34,86,39.5,52,38,9,29,56,118,34,1
ENG-Premier League,1920,Wolves,Rúben Vinagre,POR,"MF,DF",20,1999,7.2,23,13,15,6,2,12,15,80.0,3,7,2,5,11,34,22,0
ENG-Premier League,1920,Wolves,Willy Boly,CIV,DF,28,1991,22.0,57,33,36,21,0,25,43,58.1,18,28,11,17,39,96,108,3
